%%%%%%%%%%%%%%%%%%%%%%%
%$$ $$ $$ $$$ $$ $$ $$%
%      $       $      %
%$$$$$$R   B   R$$$$$$%
%                     %
% $  $     T     $  $ %
%      $       $      %
%$$$$$$    B    $$$$$$%
%  V   $$$$$$$$$  V   %
% $ $ $         $ $ $ %
%  R     $ $ $    V   %
%$$$$$$         $$$$$$%
%          $         B%
%%%%%%%%%%%%%%%%%%%%%%%
