%%%%%%%%%%%%%%%%%%%%%%
%B                   %
%         R       $  %
%          $$$$$$$$  %
%$$$$$$$$         $R %
%         B        $ %
%   $$$$$$$$$        %
%                    %
%  R        $$$$$$$  %
%   $$$$$$$$$  B     %
%%%%%%%%%%%%%%%%%%%%%%
